#################
        #.......#
# ##### #.#####.#
#   # # #.....#.#
# # # # #####.#.#
#   # #      .#.# 
### # #######.#.#
#   # #    #..#.# 
# ### # ## #.# .
#     # ##  .B#A  
#################