#################
        #       #
# ##### # ##### #
#   # # #     # #
# # # # ##### # #
#   # #       # # 
### # ####### # #
#   # #    #  # # 
# ### # ## # #  
#     # ##   B#A  
#################