########################################################################################################
#B##   #    ###
#  # ## ###     #
#    # A   #####
############


            


























































































#
#
#
#
#
#
#